1111111
1000111
100P001
1111111
