1111111
1P00101
1000001
1111111
