1111111
1000111
101P001
1111111
