1110111
1PEC1C1
1000001
1111111