11111111111111111111111111
111111C111101101111C111111
111111C100000000001C111111
111111C101110011101C111111
10CCCCC001000000100CCCCCE1
111111C101111111101C111111
111111C100000000001C111111
111111C101111111101C111111
1CCCCCCCCCCC11CCCCCCCCCCC1
1C1111C1111C11C1111C1111C1
111C11CCCCCC0PCCCCCC11CCC1
1C0CCCCCCCCCCCCCCCCCCCCCC1
11111111111111111111111111